cat /proc/cpuinfo -- Check stats about core
Note: if only one processor shows, check `uname -a` for SMP.
        Non-SMP kernals may not handle multiple processors.

getent group <groupname>
    fetches list of all members in that group (full /etc/group line)

Attributes:
    a: append only
    c: compressed (?)
    d: no dump (?)
    e: extent format (?)
    i: immutable (?)
    j: data journaling (?)
    s: secure deletion (?)
    t: no tail-merging (?)
    u: undeletable
    A: no atime updates (?)
    C: no copy on write (?)
    D: synchronous directory updates (?)
    S: synchronous updates (?)
    T: top of directory hierarchy (?)

seq  -- prints sequence of numbers (who comes up with this stuff?)

w -- shows who is logged on and what they are doing

blkid -- locate and print block device attributes

cut --  '-d' and a char sets the delimeter
        '-f' and a range of numbers sets the fields to retain

$RANDOM in bash returns a random int

BASH SHORTCUTS:
    Alt + *     :   Insert all possible completions
    Alt + Ctrl-e:   Expose aliases, history, and completions
    C-x C-e     :   Open current line's command in $EDITOR



NEW ARCHLINUX SECTION

startx -- launch Xorg server
pkill X -- kill Xorg server
